Silver spotted skipper - epargyreus clarus
Viceroy - limenitis archippus
Owl - caligo memnon
Common green birdwing - ornithoptera priamus
Orange dead leaf - Kallima inachus
Tiger longwing - heliconius ismenius
Cydno longwing - heliconius cydno
Monarch butterfly - danaus plexippus
Mexican longwing - heliconius hortense
Red rim - biblis hyperia
Plain blue crow - euploea modesta
Tailed Jay - graphium agamemnon
Common sergeant - athyma perius
Hecale longwing - heliconius hecale
Rusty tipped page - siproeta epaphus
Lemon pansy - junonia lemonias
Zebra longwing - heliconius charithonia
Blue clipper - parthenos Sylvia
Forest mort blue - caligo eurilochus
Banded peacock - papilio palinurus
Leopard lacewing - cethosia cyane
Small postman - heliconius erato
Compton tortoiseshell - nymphalis vaualbum
Thoas swallowtail - papilio thoas
Giant swallowtail - papilio cresphontes
Black swallowtail - papilio polyxenes
Brown clipper - parthenos Sylvia
Silver bordered fritillary - boloria selene
Gulf fritillary - agraulis vanillae
White admiral - limenitis arthemis
Red cracker - hamadryas amphinome
Doris longwing - heliconius doris
Common buckeye - junonia coenia
Blue morpho - morpho peleides
Pink edged sulfur - Colias interior
Striped hairstreak - satyrium liparops
Pearl crescent - phyciodes tharos
American copper - lycaena phlaeas
Milberts tortoiseshell - nymphalis milberti
Common birdwing - troides helena
Mosaic - colobura dirce
White morpho - morpho polyphemus
Mocker swallowtail - papilio dardanus
Plain tiger - danaus chrysippus
Julia - dryas iulia
Banded orange tiger - dryadula phaetusa
Rice paper - idea leuconoe
White peacock - anartia jatrophae